DWM_OK	LITERAL1
DWM_ERR_INTERNAL	LITERAL1
DWM_ERR_BUSY	LITERAL1
DWM_ERR_INVAL_ADDR	LITERAL1
DWM_ERR_INVAL_PARAM	LITERAL1
DWM_ERR_OVERRUN	LITERAL1
DWM_ERR_I2C_ANACK	LITERAL1
DWM_ERR_I2C_DNACK	LITERAL1
DWM_STATUS_LOC_DATA_READY_MASK	LITERAL1
DWM_STATUS_UWBMAC_JOINED_MASK	LITERAL1
DWM1001_INTR_NONE	LITERAL1
DWM1001_INTR_LOC_READY			LITERAL1
DWM1001_INTR_SPI_DATA_READY		LITERAL1
dwm_init	KEYWORD2
dwm_pos_t	KEYWORD1
dwm_pos_set	KEYWORD2
dwm_pos_get	KEYWORD2
dwm_upd_rate	KEYWORD1
dwm_upd_rate_set	KEYWORD2
dwm_upd_rate_get	KEYWORD2
dwm_meas_mode_t	KEYWORD1
dwm_mode_t	KEYWORD1
dwm_uwb_mode_t	KEYWORD1
dwm_cfg_common_t	KEYWORD1
dwm_cfg_anchor_t	KEYWORD1
dwm_cfg_tag_t	KEYWORD1
dwm_cfg_t	KEYWORD1
dwm_cfg_tag_set	KEYWORD2
dwm_cfg_anchor_set	KEYWORD2
dwm_cfg_get	KEYWORD2
dwm_sleep	KEYWORD2
dwm_distance_t	KEYWORD1
dwm_anchor_pos_t	KEYWORD1
dwm_ranging_anchors_t	KEYWORD1
dwm_loc_data_t	KEYWORD1
dwm_loc_get	KEYWORD2
dwm_baddr_t	KEYWORD1
dwm_baddr_set	KEYWORD2
dwm_baddr_get	KEYWORD2
dwm_reset	KEYWORD2
dwm_fw_ver_t	KEYWORD1
dwm_ver_t	KEYWORD1
dwm_ver_get	KEYWORD2
dwm_gpio_idx_t	KEYWORD1
dwm_gpio_pin_pull_t	KEYWORD1
dwm_gpio_cfg_output	KEYWORD2
dwm_gpio_cfg_input	KEYWORD2
dwm_gpio_value_set	KEYWORD2
dwm_gpio_value_get	KEYWORD2
dwm_gpio_value_toggle	KEYWORD2
dwm_status_t	KEYWORD1
dwm_status_get	KEYWORD2
dwm_int_cfg	KEYWORD2